......................................
.S#..........................#........
.............................#........
.............................#......##
....................................#.
....................................#.
..............#.......................
............#........................#
###########.#........................#
......................................
.....................#..........#.....
.....................#..........#.....
.....................#..........#.....
X.................................#...